CBETA	CBETA	CB
高丽再雕	丽再	GL
永乐北藏	永北	YB
乾隆藏	乾隆	QL
开宝藏	开宝	KB
契丹藏	契丹	QD
赵城金藏	赵城	ZC
崇宁藏	崇宁	CN
毘卢藏	毘卢	PL
圆觉藏	圆觉	YJ
资福藏	资福	ZF
思溪藏	思溪	SX
碛砂藏	碛砂	QS
卍字正藏	卍正	WZ
卍字续藏	卍续	WX
普宁藏	普宁	PN
元官藏	元官	YG
洪武南藏	洪武	HN
永乐南藏	永南	YN
嘉兴藏	嘉兴	JX
高丽初雕	丽初	LC
房山石经	房山	FS
大正藏	大正	DZ
中华藏	中华	ZH
宋藏遗珍	宋藏	SZ
